111111111111111111111111111111111111111111111111111111111111
1E000111111C000000000000000111111111110000C00000000011111111
100000011111000000000000000000011111110000000000000001111111
100000001110000000000000000000000111000000000000000000011111
100000000010000000000000000000000010000000000000000000C00111
100000000000000000000000000000000000000000000000000000000001
10000000000000000000000000000C000000000000000000000000000001
100000000000000000000000000000000000000000000000000000000001
100000000000000000000000000000000000000000000000000000000001
10000000000000C000000000000000000000000000000000000000000001
1000000000000000000000000000000000000000000000000C0000000001
100000000000000000000000000001100000000000000000000000000001
100000000000000000100000M00111111000000000000000000000000001
100000C00000000011100000111111E11111000000000000000000000001
100000000000001111100000000110000111111000000000000000000001
100001000000000011100000000010000110000000000000000000000001
100111000000000001100000000000000100000000000000000100000001
111100000000000000100000000000000000000000000000111110000001
111000000000000000100000000000000000000000000011111111111001
110000000000000000000000000000000000000000000000001110000001
10000000000C000000000000000000000000000000000000000100000001
1000000000000000000000000000000000000C0000000000000000000001
10000000000000000000000C000000000000000000000000000000000001
100000000000000000000000000000000000000000000000000000000001
10000000C0000000000000000000000000000000C0000000000000000001
100000000000000000000000000000000000000000000000000000000011
1000000000000000000000000P0010000000000000000000000000000111
100000000000000000000000000110000000000000000000000001111111
100C00000000000000000000001111100000000000000000000111111111
111111111111111111111111111111111111111111111111111111111111