111111111111111111111111
100000000000000000000001
100E00000000000000000001
11111111111111111111111