1111111
1M000P1
1C0E001
1111111