1111111
10P0001
100E001
1111111