1111111
10000P1
1C0E000
1111111