1111111111
10000P0001
1C0E000001
1000000001
1000000001
100000M001
1000000001
1000000001
1000000001
1111111111