1111111111111111111111111111111
1E0010C000000000000000000000001
1000111000000000000000000000001
1P0000000000000000000C000000001
1000000000000000000000000C00001
100C0000000000000000000000C0001
10000000000000000000C0000000001
100000C000000000000000000C00001
1E00000000000000000000000000001
1000000000000000000000000000001
1000000000000000000000000000001
1000000000000000000000000000001
1000000000000000000000000000001
1000000000000000000000000000001
1000000000000000000000000000001
1000000000000000000000000000001
1000000000000000000000000000001
1000000000000000000000000000001
1000000000000000000000000000001
1000000000000000000000000000001
1000000000000000000000000000001
1000000000000000000000000000001
1000000000000000000000000000001
1000000000000000000000000000001
1000000000000000000000000000001
1000000000000000000000000000001
1000000000000000000000000000001
1111111111111111111111111111111