111111111111111111111111111111111111
1000000000000000000000000000001000E1
100000000000000000000000000000100001
100000000000000000000000000001100001
100000000C00000000000000001111000001
100000000000000000000000001000000001
100000000000000000000000000000000001
1000C0000000000000000000000000000001
100000000000000000000000000000000001
100000000000000000000000000000000001
100000000000000000000000000000000001
100000000000000000000000000000000001
100000000000000000000000000000000001
100000000000000000000000000000000001
100000000000000000000000000000000001
100000000000000000000000000000000001
100000000000000000000000000000000001
100000000000000000000000000000000001
100000000000000000000000000000000001
10000000000000000P000000001000000001
100000000000000000000000000100000001
100000000000000000000000000011110001
100000000000000000000000000000011111
100000000000000000000000000000000001
100000000000000000000000000000000001
100000000000000000000000000000000001
100000000000000000000000000000000001
11111111000C000000000000000000000001
100000010000000000000000000000000001
1E0000010000000000000000000000000001
111111111111111111111111111111111111