NO path_to_the_north_texture
                SO path_to_the_south_texture
                WE path_to_the_west_texture
                EA path_to_the_east_texture
                F 0,0,0
                C 0,10,0
11111
10001
10001
1N001             
11111
