1111111
1000001
1C0E001
1111111