NO ./assets/128x128/no_texture.xpm
EA ./assets/128x128/ea_texture.xpm
WE ./assets/128x128/we_texture.xpm
SO ./assets/128x128/so_texture.xpm

F 24,24,23
C 109,109,109

111111111111111111111111111111111111111111111111111111111
100000000000000100000000001001000000010000000000000000001
100000000000000100000000001001000000010000000000000000001
100000000000000100000000001001000000010000000000000000001
100000000000000100000000001001000000010000000000000000001
100000000000000100000000001001000000010000000000000000001
1111111111111101111011111110011111110111111111111111111011111111   1111111111
1000000000000000000000000000000000000000000000000000000000000001   1000000001
1000000000000000000000000000000000000000000000000000000011111001   1001111001
111111111111101111110111101000101111110111110111111111111   1001   1001  1001
100000000000101000010100100000001000010100010100000000001   1001   1001  1001
100000000000101000010100100000001000010100010100000000001   10011111001  1001
111111111111101111110111101000101111110111110111111111111   10000000001  1001
100000000000000000000000000000000000000000000000000000001   10000000001  1001
100000000000000000000000000000000000000000000000000000001   11111111111  1001
111111101111111111011111111000111111011111111111111111101                1001
100100000000000001000000001000100000000000000001110000001                1001   
100010000000000010000000001000100000000000000001110000001                1001
100000000000000100000000001000100000000000000001110000001                1001
100000100000001000000000001000100000000000000001111100001                1001
1000000100000100000000000010N0100000000000000001111100001                1001111111
111111111111111111111111111101111111111111111111111111111                1000000001
                          10001                                          1111111001
                          10001                                                1001
                          10001                                                1001
                          100011111111111111111111111111111111111111111111111111001
                          100000000000000000000000000000000000000000000000000000001
                          100000000000000000000000000000000000000000000000000000001
                          111111111111111111111111111111111111111111111111111111111