NO ./assets/realistic/no_texture.xpm
EA ./assets/realistic/ea_texture.xpm
WE ./assets/realistic/we_texture.xpm
SO ./assets/realistic/so_texture.xpm

F 252,186,3
C 109,109,109

111111111111111111111111111111111111111111111111111111111
100000000000000100000000001001000000010000000000000000001
100000000000000100000000001001000000010000000000000000001
100000000000000100000000001001000000010000000000000000001
100000000000000100000000001001000000010000000000000000001
100000000000000100000000001001000000010000000000000000001
111111111111110111101111111001111111011111111111111111101
100000000000000000000000000000000000000000000000000000001
100000000000000000000000000000000000000000000000000000001
111111111111101111110111111000111111110111110111111111111
100000000000101000010100010000010000010100010100000000001
100000000000101000010100010000010000010100010100000000001
111111111111101111110111111000111111110111110111111111111
100000000000000000000000000000000000000000000000000000001
100000000000000000000000000000000000000000000000000000001
111111101111111111011111111000111111011111111111111111101
100100000000000001000000001000100000000000000001110000001
100010000000000010000000001000100000000000000001110000001
100000000000000100000000001000100000000000000001110000001
100000100000001000000000001000100000000000000001111100001
1000000100000100000000000010N0100000000000000001111100001
111111111111111111111111111111111111111111111111111111111
