111111111111111
1E0000C00000001
1000000000M0001
100000C0000C001
100000000000001
10C000000000001
100000000000001
100000P00000001
100000000000001
100000000000001
100000000000001
100000000000001
100C00000000001
100000000000001
100000C000000E1
111111111111111
