11111111111
10000P0M001
1C0E0000001
10000000001
10000000001
100000M0001
10000000001
10000000001
100M0000M01
10000000001
11111111111